111111111
11P112011
100100011
1C01101E1
111111111