1111111111111111111111111111111111
1E0000001000000C00000C0000N0000001
1010010100100000101001000000010101
1010010010101010001001000000010101
1P00N0000C00C000000N0000000N0000C1
1111111111111111111111111111111111